ack: Search tool like grep, but optimized for programmers
act: Run your GitHub Actions locally ðŸš€
age: Simple, modern, secure file encryption
aria2: Download with resuming and segmented downloading
autojump: Shell extension to jump to frequently used directories
awscli: Official Amazon AWS command-line interface
bat: Clone of cat(1) with syntax highlighting and Git integration
blueutil: Get/set bluetooth power and discoverable state
boost: Collection of portable C++ source libraries
cmocka: Unit testing framework for C
colordiff: Color-highlighted diff(1) output
composer: Dependency Manager for PHP
coreutils: GNU File, Shell, and Text utilities
diff-so-fancy: Good-lookin' diffs with diff-highlight and more
docker: Pack, ship and run any application as a lightweight container
dos2unix: Convert text between DOS, UNIX, and Mac formats
e2fsprogs: Utilities for the ext2, ext3, and ext4 file systems
bore: A simple CLI tool for making tunnels to localhost.
exa: Modern replacement for 'ls'
exiftool: Perl lib for reading and writing EXIF metadata
fd: Simple, fast and user-friendly alternative to find
ffmpeg: Play, record, convert, and stream audio and video
findutils: Collection of GNU find, xargs, and locate
flux: Lightweight scripting language for querying databases
fnm: Fast and simple Node.js version manager
gawk: GNU awk utility
git: Distributed revision control system
git-flow: Extensions to follow Vincent Driessen's branching model
git-lfs: Git extension for versioning large files
gnupg: GNU Pretty Good Privacy (PGP) package
gobject-introspection: Generate introspection data for GObject libraries
golangci-lint: Fast linters runner for Go
grep: GNU grep, egrep and fgrep
sshfs-mac: File system client based on SSH File Transfer Protocol
grpc: Next generation open source RPC library and framework
guile: GNU Ubiquitous Intelligent Language for Extensions
helm: Kubernetes package manager
htop: Improved top (interactive process viewer)
jq: Lightweight and flexible command-line JSON processor
k9s: Kubernetes CLI To Manage Your Clusters In Style!
kdash: A fast and simple dashboard for Kubernetes written in Rust
kubectx: Tool that can switch between kubectl contexts easily and create aliases
lazygit: Simple terminal UI for git commands
libmaxminddb: C library for the MaxMind DB file format
libsmi: Library to Access SMI MIB Information
libssh: C library SSHv1/SSHv2 client and server protocols
lua: Powerful, lightweight programming language
m-cli: Swiss Army Knife for macOS
micro: Modern and intuitive terminal-based text editor
mitmproxy: Intercept, modify, replay, save HTTP/S traffic
mosh: Remote terminal application
mysql-client: Open source relational database management system
nano: Free (GNU) replacement for the Pico text editor
neovim: Ambitious Vim-fork focused on extensibility and agility
node: Platform built on V8 to build network applications
nvm: Manage multiple Node.js versions
oci-cli: Oracle Cloud Infrastructure CLI
php@7.4: General-purpose scripting language
pigz: Parallel gzip
pinentry-mac: Pinentry for GPG on Mac
poetry: Python package management tool
putty: Implementation of Telnet and SSH
pv: Monitor data's progress through a pipe
pyenv: Python version management
rclone: Rsync for cloud storage
redis: Persistent key-value database, with built-in net interface
rename: Perl-powered file rename script with many helpful built-ins
rustup-init: Rust toolchain installer
sbcl: Steel Bank Common Lisp system
screen: Terminal multiplexer with VT100/ANSI terminal emulation
smartmontools: SMART hard drive monitoring
starship: Cross-shell prompt for astronauts
terminal-notifier: Send macOS User Notifications from the command-line
terraform: Tool to build, change, and version infrastructure
tesseract-lang: Enables extra languages support for Tesseract
testdisk: Powerful free data recovery utility
the_silver_searcher: Code-search similar to ack
tiger-vnc: High-performance, platform-neutral implementation of VNC
tldr: Simplified and community-driven man pages
tmux: Terminal multiplexer
tree: Display directories as trees (with optional color/HTML output)
wget: Internet file retriever
wifi-password: Show the current WiFi network password
wrk: HTTP benchmarking tool
you-get: Dumb downloader that scrapes the web
youtube-dl: Download YouTube videos from the command-line
zsh: UNIX shell (command interpreter)
zsh-completions: Additional completion definitions for zsh
